111100000000000
000000000000000
000100000000000
000000000000000
000100000000000
000111000000000
000111000000000
000111000000000
000000000000000
000000000000000
000001000000000
000011000000000
000001000010000
100001000011000
100000000001000
000000011111000
000000000111000
000000000000000
000000000000000
000000000000000