111100000000000
000000000000000
000100000000000
110000000000001
111100000000011
000000000000111
000000000001111
000000000011111
000000000111111
000000000000000
000000000000000
000001000000000
000001000010000
100001000011000
100000000001000
000000000000000
000000001111000
000000001100000
000000001100000
000000001000000