000000000000000
000000000000000
100000000000000
111110000000000
100000000000000
110000010000000
100000010000000
100000010000000
110000010000000
110000010000000
110000000000000
000000000000000
000000000000000
000000000000000
000000000000000
000000000000000
000000000000000
000000000000011
000000000000011
000000000000011